Gd, Gd, Gd, Gd, Gd, Gd, Gd^Gvs, Gd^Gvs, Gd^Gvs, Gd^Gvs, Gd^Gvs, Gd, Gs, Gd, Gs, Gd, Gd^Gvs, Gd^Gvs, Gd^Gvs, Gd^Gvs, Gd, Gd, Gd, Gd, Gs, Gd, Gs^Fds, Gd, Ww, Gd, Gd, Gd, Gd
Rr, Gd, Gd, Gd, Gd, Gd, Gd, Gd^Gvs, Gd^Gvs, Gd^Gvs, Gd, Gs, Gs, Gs, Gs, Gs, Gd^Gvs, Gd^Gvs, Gd^Gvs, Gd^Gvs, Gd, Gd, Ce, Gs, Gs, Gs, Ww, Ww, Ww^Vm, Gs^Fds, Gs, Gd, Gd
Gd, Rr, Gd, Gd, Gs, Gs^Vh, Gd, Gd, Gd, Gd, Gd, Gd, Gd, Gs, Gd, Gd, Gd^Gvs, Gd^Gvs, Gd, Gd, Ce, Ce, Gs, Gs, Gs^Fds, Gs^Fds, Ww, Ww, Gs^Fds, Gs, Gs, Gd, Gd
Gd, Rr, Rr, Gs, Gs, Gs, Gs, Gs, Gs, Gd, Gd, Gd, Gs^Vh, Gd, Gd, Gd, Gd, Gs^Vh, Gd, Gd, Gd, Gd, Gs, Gs^Fds, Ww, Ww, Ww, Ww, Gs, Gs, Gd, Gd, Gd
Gd, Gs, Gd, Rr, Gd, Gs, Gs, Gs, Ch, Gs, Gd, Gd, Gd, Gd, Gd^Gvs, Gd^Gvs, Gd^Gvs, Gd, Ch, Gd, Gd, Gs, Wwf, Ww, Ww, Ww, Ds, Ds, Gs, Gd, Gd, Gd, Gd
Gs, Gs, Gs^Vh, Rr, Gd, Gs, Gs, Ch, Ch, Gs, Gs, Gd, Gd^Gvs, Gd^Gvs, Gd^Gvs, Gd^Gvs, Gd^Gvs, Gd^Gvs, Gd, Gd, Gs, Gs^Fds, Ww, Ww, Ds, Ds, Gs, Gs, Gs, Gs, Gd, Gd, Gd
Gs, Gs, Gs, Rr, Rr, Gs, Gs, Ch, Ch, Kh, Gs, Gd, Gd, Gd^Gvs, Gd^Gvs, Gd^Gvs, Gd, Gd, Gs, Gs, Gs^Fds, Gs^Fds, Ww, Wwf, Gd, Gs, Gd, Gd, Gd, Gs, Gs, Gd, Gd
Gs, Gd, Gs, Gs, Gs, Rr, Rr, Gs, Gs, Ch, Gs, Gs, Gs, Gd, Gd, Gd, Ch, Ch, Gs, Gs, Ww, Ww, Ww, Ww, Gd, Gd, Gd^Gvs, Gd, Gd, Gd, Gs, Gd, Gd
Gs, Gs, Gs, Gs, Gs, Gs, Gs, Rr, Rr, Gs, Ch, Gs, Ch, Gd, Ds, Gd, Ds, Ds, Ww, Ww, Ww, Ww, Gd, Gd, Gd^Gvs, Gd^Gvs, Gd^Gvs, Gd^Gvs, Gd^Gvs, Gd, Gs, Gs, Gd
Gd, Gd, Gd, Gd, Gd, Gd, Gd, Gs, Rr, Gd, Gd, Ch, Gs, Ds, Ww, Ds, Ww, Ww, Ww, Ww, Gd, Gd, Gd, Gd^Gvs, Gd^Gvs, Gd^Gvs, Gd^Gvs, Gd^Gvs, Gd, Gd, Gd, Gs, Gd
Gd, Gs, Gd, Gd, Gd, Gd, Ch, Gs, Gs, Rr, Rr, Gs, Ww, Ww, Ww, Ww, Ww, Ww, Ds, Ww, Wwf, Gd, Gd, Gd, Gd, Gd^Gvs, Gd, Gd, Gd, Gd, Gd, Gd, Hh
Gd, Gs, Gs, Gd, Gd, Gd, Ch, Gs, Ds, Ch, Ww, Ww^Bsb\, Ww^Bsb\, Ww, Ds, Ds, Ds, Ds, Gs, Gs, Gs, Wwf, Gs, Gd, Gs^Vc, Gd, Gd, Gd, Gd, Gd, Hh, Hh, Gs^Fds
Gd, Gs, Gs, Gs, Gd, Ch, Ds, Ds, Ww, Ww, Ww, Ww, Gd, Rr, Gs, Gs, Gd, Gd, Gd, Gs, Gs^Efm, Wwg, Gs, Gs, Gd, Gs, Gs, Gs, Gs^Efm, Gd, Gs^Fds, Gs^Fds, Gs^Fds
Gd, Gs, Gs, Gs, Gs, Gs, Ww^Bw\r, Ww, Ww, Ww, Ds, Ds, Gs^Vc, Rr, Rr, Gd, Gd, Gd, Gd, Gd, Gs^Efm, Wwg, Wwg, Gs, Wwf, Gs, Wwg, Gs^Efm, Wwg, Gs^Efm, Gd^Efm, Gs^Efm, Ww
Gd, Ce, Gs, Ds, Ds, Ds, Ww, Ww, Ww, Ds, Gs, Gd, Gd, Gd, Gd, Rd, Rd, Gd, Gd, Gd, Gs, Gs^Efm, Gs^Efm, Wwf, Gs, Wwf, Gs, Wwg, Gs, Wwf, Wwg, Wwg, Gd
Gs, Gs, Ds, Ds, Ds, Ds, Ww, Ww, Ds, Ds, Gs, Gd, Gd^Gvs, Gd^Gvs, Gd^Gvs, Gd, Gd, Rd, Rd, Gd, Gs, Gs^Efm, Gd, Gd^Efm, Gd, Gs, Gd, Gs, Gd, Gd, Gd, Gd, Gd
Ww, Ww, Ww, Ww, Ww, Ww, Ww, Ww, Gs^Efm, Gs, Gd, Gd^Gvs, Gd^Gvs, Gd^Gvs, Gd^Gvs, Gd^Gvs, Gd, Gd, Gd, Rd, Rd, Gd, Gd, Gd, Hhd, Gd, Gd, Gd, Gd, Gd, Gd, Gd, Gd
Ww, Ww, Ww, Ww, Ww, Ww, Gs^Efm, Gs^Efm, Gs, Gs, Gd, Gd, Gd, Gd^Gvs, Gd, Gd, Gd, Gd, Gd, Gs^Vc, Gd, Rd, Gd, Hhd, Gs, Gs, Gs, Gd, Gd, Gd, Gd, Gd, Gd
Ww, Ww, Gs^Fms, Ds, Gs^Vc, Gs^Fms, Gs, Gs, Gd, Gd, Gd, Gd, Gd, Gd, Gd, Gd, Hhd, Hhd, Gd, Gd, Gd, Rd, Gd, Gd, Gd, Gd, Gd, Gs, Gd, Gd, Gs^Vc, Gd, Gd
Gs, Gs, Gs, Gd, Gd, Gs, Gd, Gd, Gd, Gd, Gd, Gd, Gd, Gd, Gd, Gd, Gd, Gd, Gd, Gd, Gd, Rd, Gd, Gd, Gd, Cer, Cer, Gd, Gd, Gd, Gd, Gd, Gd
Gs, Gs, Gd, Gd, Gd^Gvs, Gd, Gd, Gd, Gs, Gd, Gd, Gd, Gs^Vc, Gd, Gd, Gd, Gs^Fms, Gd, Gd, Gd, Gs, Rd, Gd, Gd, Gd, Cer, Ker, Cer, Gd, Gd, Gd, Gd, Gd
Gd, Gd, Gd^Gvs, Gd^Gvs, Gd^Gvs, Gd^Gvs, Gd^Gvs, Gd, Gs, Gd, Gd, Gd, Gd, Gd, Gd, Gd, Gd, Gs^Fms, Gs, Gs, Gs, Rd, Rd, Gd, Gd, Gd, Gd, Gd, Gd, Gd, Gd, Gd, Gd
Gd, Gd, Gd, Gd^Gvs, Gd, Gd^Gvs, Gd, Gd, Gd, Gd, Gd, Gd, Gd, Gd, Gd, Gd, Gd, Gd, Gd, Gd, Gd, Gd, Rd, Rd, Gd, Gd, Gd, Gd, Gd, Gd, Gd, Gd, Gd
