Qxu, Qxu, Qxu, Qxu, Qxu, Qxu, Qxu, Qxu, Qxu, Qxu, Qxu, Qxu, Qxu, Qxu, Qxu, Qxu, Qxu, Qxu, Qxu, Qxu, Qxu
Qxu, Qxu, Qxu, Qxu, Qxu, Qxu, Qxu, Qxu, Qxu, Qxu, Uu^Vu, Qxu, Qxu, Qxu, Qxu, Qxu, Uu^Vu, Qxu, Qxu, Qxu, Qxu
Qxu, Qxu, Uu, Uu^Vu, Uu, Qxu, Uh, Uh, Uu, Uu, Uu, Uu, Uu, Qxu, Uu, Uu, Uu, Uu, Uu, Qxu, Qxu
Qxu, Qxu, Uu, Urb, Urb, Uh, Uu, Uu, Uu, Uu, Ur, Xu, Xu, Uu, Xu, Xu, Xu, Uu, Qxu, Qxu, Qxu
Qxu, Qxu, Uu, Uu, Qxu, Urb, Urb, Uu^Vu, Qxu, Qxu, Ur, Xu, Qxu, Uu, Urb, Xu, Uu, Xu, Qxu, Qxu, Qxu
Qxu, Qxu, Uu, Qxu, Qxu, Qxu, Uh, Qxu, Qxu, Qxu, Uu, Qxu, Qxu, Qxu, Urb, Uu, Uu^Uf, Uu^Uf, Qxu, Qxu, Qxu
Qxu, Qxu, Uu, Qxu, Xu, Xu, Uh, Qxu, Qxu, Qxu, Urb, Qxu, Qxu, Urb, Uh, Uh, Qxu, Qxu, Qxu, Qxu, Qxu
Qxu, Qxu, Qxu, Uu, Uu, Xu, Uu, Qxu, Qxu, Qxu, Urb, Qxu, Qxu, Uu, Uh, Qxu, Uu, Uu^Vu, Qxu, Qxu, Qxu
Qxu, Qxu, Qxu, Uu^Uf, Uu, Uu, Urb, Qxu, Qxu, Qxu, Uu, Qxu, Qxu, Urb, Uh, Uu, Qxu, Qxu, Uu^Uf, Qxu, Qxu
Qxu, Qxu, Qxu, Uh, Uh, Urb, Qxu, Uh, Uu, Uu, Cud, Uu, Uu, Uu, Uu, Uu, Uu, Uu^Uf, Uu, Uu^Vu, Qxu
Qxu, Qxu, Uu^Vu, Uh, Qxu, Qxu, Qxu, Qxu, Uu, Cud, Kud, Cud, Uu, Qxu, Qxu, Uu, Uu, Uu, Qxu, Qxu, Qxu
Qxu, Qxu, Qxu, Qxu, Qxu, Qxu, Qxu, Qxu, Uu, Cud, Cud, Cud, Uu, Qxu, Qxu, Qxu, Qxu, Qxu, Qxu, Qxu, Qxu
Qxu, Qxu, Qxu, Qxu, Qxu, Qxu, Uue, Uu, Qxu, Uu, Uu, Uu, Qxu, Uh, Uu^Uf, Qxu, Uue, Uu^Vu, Uu, Qxu, Qxu
Qxu, Qxu, Uu^Uf, Uu^Vu, Uu, Uue, Qxu, Qxu, Qxu, Qxu, Uu, Qxu, Qxu, Qxu, Qxu, Uue, Uu, Uu, Qxu, Qxu, Qxu
Qxu, Uu^Uf, Uu, Uu, Uu, Uh, Uh, Qxu, Qxu, Qxu, Ur, Qxu, Qxu, Qxu, Xu, Uu, Uu, Uu, Qxu, Qxu, Qxu
Qxu, Uue, Uue, Xu, Xu, Uh, Uh, Qxu, Qxu, Qxu, Uu, Qxu, Qxu, Qxu, Xu, Uu^Vu, Qxu, Uu, Qxu, Qxu, Qxu
Qxu, Uh, Uh, Uue, Xu, Uue, Uue, Uu^Vu, Qxu, Qxu, Ur, Xu, Xu, Xu, Qxu, Xu, Xu, Qxu, Qxu, Qxu, Qxu
Qxu, Uh, Uh, Uu, Uu, Uue, Uu, Uu^Uf, Qxu^Bs\, Qxu, Ur, Uu^Vu, Xu, Qxu, Qxu, Qxu, Uue, Xu, Xu, Qxu, Qxu
Qxu, Qxu, Qxu, Uu, Uu, Uu, Qxu, Qxu, Qxu, Qxu^Bs\, Uu, Uu^Uf, Uh, Qxu, Qxu, Qxu, Uu, Uue, Xu, Qxu, Qxu
Qxu, Qxu, Qxu, Qxu, Qxu, Qxu, Qxu, Qxu, Qxu, Qxu, Uu, Qxu, Qxu, Uu, Uh, Uu, Uu, Uue, Qxu, Qxu, Qxu
Qxu, Qxu, Qxu, Qxu, Qxu, Qxu, Qxu, Qxu, Qxu, Qxu, Uu, Qxu, Qxu, Qxu, Qxu, Qxu, Qxu, Qxu, Qxu, Qxu, Qxu
Qxu, Qxu, Qxu, Qxu, Qxu, Qxu, Qxu, Qxu, Qxu, Qxu, Qxu, Qxu, Qxu, Qxu, Qxu, Qxu, Qxu, Qxu, Qxu, Qxu, Qxu
