Xu, Xu, Xu, Xu, Xu, Xu, Xu, Xu, Xu, Xu, Xu, Xu, Xu, Xu, Xu, Xu, Xu, Xu, Xu, Xu, Xu, Xu, Xu, Xu, Xu, Gg, Gg, Gg, Gg, Gg, Gg, Gg, Gg, Gg, Gg, Gg
Xu, Xu, Xu, Xu, Xu, Xu, Xu, Xu, Uu, Xu, Xu, Xu, Uu^Vu, Xu, Xu, Xu, Xu, Xu, Xu, Xu, Xu, Xu, Cud, Xu, Xu, Gg, Gg, Gg, Gg, Gg, Gg, Gg, Gg, Gg, Gg, Gg
Xu, Xu, Xu, Xu, Xu, Xu, Xu, Xu, Uu, Uu, Xu, Uu, Uu, Xu, Xu, Xu, Xu, Xu, Xu, Xu, Xu, Cud, Kud, Cud, Xu, Gg, Gg, Gg, Gg, Gg, Gg, Gg, Ce, Gg, Gg, Gg
Xu, Xu, Xu, Xu, Xu, Xu, Xu, Xu, Uu, Uu, Uu, Uu, Uu, Xu, Xu, Xu, Xu, Xu, Xu, Xu, Xu, Cud, Cud, Cud, Xu, Gg, Gg, Gg, Gg, Gs^Vh, Gg, Ce, Ke, Ce, Gg, Gg
Xu, Xu, Xu, Xu, Uu^Vu, Xu, Uu, Uu, Uu, Uu, Xu, Uu, Uu, Xu, Xu, Xu, Xu, Xu, Xu, Xu, Xu, Xu, Uu, Xu, Xu, Gg, Gg, Gg, Gg, Gg, Gg, Ce, Ce, Ce, Gg, Gg
Xu, Xu, Xu, Uu, Uu, Uu, Uu, Uu, Uu, Xu, Xu, Xu, Uu, Uu, Rb, Xu, Xu, Xu, Xu, Xu, Uu^Vu, Uu, Uu, Uu, Xu, Xu, Xu, Gg, Xu, Gg, Gg, Gg, Gg, Gg, Gg, Gg
Xu, Xu, Uu, Uu, Uu, Uu, Uu, Xu, Xu, Xu, Xu, Uu^Vu, Xu, Uu, Uu, Uu, Xu, Xu, Xu, Xu, Uu, Uu, Uu, Uu, Xu, Xu, Xu, Xu, Xu, Xu, Uu, Gg, Xu, Xu, Xu, Xu
Xu, Xu, Uu, Uu, Uu, Uu, Xu, Xu, Uu, Uu^Vu, Uu, Xu, Xu, Xu, Uu, Uu, Uu, Xu, Uu, Xu, Xu, Uu, Uu, Uu, Uu, Uu, Uu, Uu^Vu, Xu, Xu, Uu, Uu, Xu, Xu, Xu, Xu
Xu, Xu, Uu, Uu, Uu, Uu, Xu, Xu, Uu, Uu, Uu, Uu, Uu, Xu, Xu, Rb, Rb, Uu, Uu, Uu^Vu, Xu, Xu, Xu, Uu, Uu, Uu, Uu, Xu, Rb, Rb, Uu, Uu, Xu, Xu, Xu, Xu
Xu, Xu, Xu, Uu, Uu^Vu, Uu, Xu, Xu, Uu, Uu, Xu, Uu, Uu, Uu, Uu^Vu, Xu, Xu, Rb, Uu, Uu, Uu, Xu, Uu, Uu, Rb, Uu, Rb, Uu, Uu, Rb, Uu, Uu, Uu, Xu, Xu, Xu
Xu, Xu, Xu, Xu, Xu, Xu, Cud, Cud, Cud, Uu, Xu, Xu, Uu, Uu, Uu, Xu, Xu, Xu, Xu, Uu, Rb, Rb, Uu, Uu, Uu, Rb, Xu, Uu, Xu, Xu, Xu, Uu, Rb, Uu, Uu^Vu, Xu
Xu, Xu, Xu, Xu, Xu, Xu, Cud, Kud, Cud, Xu, Xu, Xu, Uu, Uu, Uu, Xu, Xu, Xu, Uu, Uu, Ur, Uu, Xu, Uu, Uu, Xu, Xu, Xu, Uu, Xu, Xu, Xu, Xu, Rb, Rb, Xu
Xu, Xu, Xu, Xu, Xoi, Xu, Xu, Cud, Xu, Xu, Uu, Uu, Uu, Uu, Xu, Xu, Uu, Uu, Uu, Ur, Uu, Uu, Xu, Xu, Uu, Uu, Uu, Uu, Uu, Uu, Xu, Xu, Xu, Rb, Rb, Xu
Xu, Xoi, Xoi, Xoi, Ior, Xoi, Xoi, Xu, Xu, Uu^Vu, Uu, Uu, Xu, Xu, Uu^Vu, Uu, Ur, Ur, Uu, Uu, Xu, Xu, Xu, Xu, Uu, Uu, Uu, Uu, Uu, Uu, Xu, Xu, Xu, Uu, Uu, Xu
Xoi, Xoi, Iwr, Icn, Ior, Ior, Ior, Xoi, Xoi, Xu, Uu, Uu, Xu, Xu, Uu, Ur, Ur, Uu, Xu, Xu, Xu, Xu, Xu, Uu^Vu, Uu, Uu, Xu, Uu, Xu, Uu, Xu, Xu, Uu, Uu, Uu, Xu
Xoi, Icn, Iwr, Ior, Ior, Ior, Ior, Ior, Xoi, Xu, Uu, Uu, Uu, Uu, Uu, Uu, Uu, Uu, Xu, Xu, Xu, Xu, Xu, Xu, Xu, Xu, Uu^Vu, Xu, Uu, Xu, Uu, Uu, Uu, Uu, Xu, Xu
Xoi, Ior, Ior, Ior, Iwr, Iwr, Ior, Ior, Xoi, Xu, Uu, Uu, Uu, Uu, Xu, Uu, Ur, Ur, Uu, Xu, Xu, Xu, Uu, Uu, Uu, Uu, Uu, Uu, Uu, Uu, Uu, Uu, Uu, Uu, Xu, Xu
Xoi, Ior, Ior, Iwr, Ior, Ior, Icn, Icn, Xoi, Xu, Xu, Uu, Uu, Uu, Xu, Uu, Uu, Ur, Uu, Uu^Vu, Xuc, Xu, Uu, Uu, Uu, Uu, Xu, Uu, Xu, Uu, Xu, Uu, Xu, Xu, Xu, Xu
Xu, Xoi, Xoi, Iwr, Rr^Pw|, Ior, Xoi, Xoi, Xoi, Xu, Xu, Uu, Uu^Vu, Uu, Uu, Xu, Xu, Ur, Uu, Uu, Uu, Xuc, Xuc, Uu, Uu, Xu, Xu, Xu, Xu, Xu, Xu, Xu, Xu, Xu, Xu, Xu
Xu, Xu, Xos, Xoi, Urb, Xoi, Xos, Xos, Xos, Xu, Xu, Uu, Uu, Uu, Xu, Uu, Xu, Rb, Rb, Urb, Urb, Uu, Rb, Xu, Xu, Xu, Xu, Xu, Xu, Xu, Xu, Xu, Xu, Xu, Xu, Xu
Xu, Xu, Xos, Urb, Urb, Urb, Urb, Urb, Urb, Xos, Xos, Xu, Xu, Xu, Xu, Xu, Cud, Xu, Xu, Rb, Uu, Urb, Rb, Ur, Ur, Xu, Xu, Xu, Xu, Xu, Xu, Xu, Xu, Xu, Xu, Xu
Xu, Xu, Xos, Urb^Ebn, Urb, Urb, Urb, Urb, Urb, Urb, Urb, Xos, Xos, Xu, Xu, Cud, Kud, Cud, Xu, Xuc, Uu, Urb, Urb, Rb, Ur, Xu, Xu, Xu, Xu, Xu, Xu, Xu, Xu, Xu, Xu, Xu
Xu, Xu, Xu, Xos, Xu, Xos, Xos, Urb, Urb, Urb, Urb, Urb, Urb, Xuc, Xuc, Cud, Cud, Cud, Xuc, Xuc, Uu^Vu, Urb, Rb, Uu, Ur, Xu, Xu, Xu, Uu^Vu, Xu, Xu, Xu, Xu, Xu, Xu, Xu
Xu, Xu, Xu, Xu, Uu^Vu, Xu, Xu, Xos, Xuc, Urb, Rb, Urb, Urb, Urb, Urb, Xuc, Xuc, Uu, Uu, Uu, Urb, Urb, Rb, Uu, Xu, Xu, Uu, Uu, Uu, Uu, Uu, Xu, Xu, Xu, Xu, Xu
Xu, Xu, Xu, Uu, Uu, Uu, Xu, Xu, Xu, Xuc, Xuc, Rb, Rb, Urb, Urb, Urb, Urb, Uu, Urb, Urb, Rb, Rb, Uu^Br\, Rb, Xom, Xom, Uu, Uu, Uu^Br/, Uu^Br/, Uu, Xu, Xu, Xu, Xu, Xu
Xu, Xu, Xu, Uu, Uu, Uu, Uu, Uu, Uu, Xu, Uu, Xuc, Uu, Rb, Uu, Urb, Urb, Urb, Rb, Rb, Uu, Rb, Uu, Uu^Br\, Uu^Br\, Uu, Uu^Br/, Uu^Br/, Uu, Uu, Uu, Xu, Xu, Xu, Xu, Xu
Xu, Xu, Xu, Xu, Xu, Uu, Uu, Uu, Uu, Uu, Uu, Uu, Uu^Vu, Uu, Uu, Uu, Uu, Rb, Xu, Xu, Xu, Xu, Uu^Vu, Uu, Uu, Uu^Br/, Uu, Uu, Uu, Uu, Xu, Xu, Xu, Xu, Xu, Xu
Xu, Xu, Xu, Xu, Xu, Xu, Xu, Xu, Xu, Xu, Xu, Xu, Xu, Xu, Xu, Xu, Xu, Xu, Xu, Xu, Xu, Xom, Xom, Xom, Xom, Xom, Xom, Xom, Xom, Xom, Xu, Xu, Xu, Xu, Xu, Xu
