Xu, Xu, Xu, Xu, Xu, Xu, Xu, Xu, Xu, Xu, Xu, Xu, Xu, Xu, Xu, Xu, Xu, Xu, Xu, Gg, Gg, Gg, Gg, Gg, Gg, Gg, Gg, Gg, Gg, Gg
Xu, Xu, Xu, Xu, Xu, Xu, Xu, Xu, Xu, Xu, Xu, Xu, Xu, Xu, Xu, Xu, Cud, Xu, Xu, Gg, Gg, Gg, Gg, Gg, Gg, Gg, Gg, Gg, Gg, Gg
Xu, Xu, Xoi, Xu, Xoi, Xoi, Xoi, Xu, Xu, Xu, Xu, Xu, Xu, Xu, Xu, Cud, Kud, Cud, Xu, Gg, Gg, Gg, Gg, Gg, Gg, Gg, Ce, Gg, Gg, Gg
Xu, Xu, Xoi, Xoi, Icn, Ior, Ior, Xoi, Xoi, Xu, Xu, Xu, Xu, Xu, Xu, Cud, Cud, Cud, Xu, Gg, Gg, Gg, Gg, Gs^Vh, Gg, Ce, Ke, Ce, Gg, Gg
Xu, Xoi, Icn, Iwr, Ior, Ior, Ior, Ior, Ior, Xoi, Xu, Xu, Xu, Xu, Xu, Uu, Uu, Xu, Xu, Gg, Gg, Gg, Gg, Gg, Gg, Ce, Ce, Ce, Gg, Gg
Xu, Xoi, Ior, Iwr, Ior, Ior, Iwr, Ior, Ior, Xoi, Xu, Xu, Xu, Xu, Uu^Ii, Uu, Uu, Uh^Ii, Xu, Xu, Xu, Gg, Xu, Gg, Gg, Gg, Gg, Gg, Gg, Gg
Xu, Xoi, Ior, Ior, Iwr, Iwr, Ior, Ior, Icn, Xoi, Xu, Xu, Xu, Xu, Uh^Ii, Uu, Uu, Uu, Xu, Xu, Xu, Xu, Xu, Xu, Uu^Ii, Gg, Xu, Xu, Xu, Xu
Xu, Xoi, Xoi, Ior, Iwr, Ior, Ior, Icn, Xoi, Xoi, Xu, Xu, Uu, Xu, Xu, Uh, Uu^Ii, Uu, Uu, Uu^Ii, Uu, Uu^Ii, Xu, Xu, Uu^Ii, Uu^Ii, Xu, Xu, Xu, Xu
Xu, Xu, Xu, Xoi, Xoi, Rr^Pw|, Xoi, Xoi, Xu, Xu, Rb, Uu, Uu, Uu^Vu, Xu, Xu, Xu, Uu, Uu^Ii, Uu, Uu, Xu, Rb, Rb^Ii, Uu^Ii, Uu^Ii, Xu, Xu, Xu, Xu
Xu, Xu, Xos, Xos, Urb, Urb, Urb^Ebn, Xos, Xos, Xu, Xu, Rb, Uh^Ii, Uu, Uu, Xu, Xu, Uu^Ii, Ur^Ii, Uu^Ii, Rb, Xu, Uu^Ii, Rb, Uu, Uu^Ii, Uu, Xu, Xu, Xu
Xu, Xu, Xos, Rb, Urb, Urb, Urb, Uu^Vud, Xos, Xu, Xu, Xu, Xom, Uu, Ur, Ur^Ii, Ur, Ur, Uu, Uu, Uu^Ii, Uu, Uu^Ii, Uu, Uu^Ii, Uu, Rb, Uu^Ii, Uu^Vu, Xu
Xu, Xu, Xos, Rb, Urb, Urb, Urb, Rb, Xos, Xu, Xom, Xom, Ur, Uu^Vu, Ur, Ur, Uu, Uu, Uu^Ii, Uh^Ii, Uu^Vu, Uu, Uu, Uu^Ii, Xu, Xu, Uh^Ii, Rb^Ii, Rb, Xu
Xu, Xu, Xos, Rb, Urb, Urb, Urb, Rb, Xos, Xom, Uu, Ur, Ur, Ur, Ur, Uu, Xom, Uu, Uu, Uu, Uu^Ii, Uh, Uu, Uu, Xu, Xu, Xu, Rb, Rb, Xu
Xu, Xu, Xos, Rb, Urb, Urb, Urb, Rb, Xos^Efs, Uu^Vu, Rb, Rb, Uu, Ur^Ii, Xom, Xom, Xu, Xu, Uu, Uu, Uh, Uh, Uh, Uu, Xu, Xu, Xu, Uu^Ii, Uu, Xu
Xu, Xu, Xu, Rb, Rb, Urb, Urb, Urb, Urb^Ii, Rb, Urb, Urb, Xom, Xom, Xu, Xu, Xu, Uu^Vu, Uu^Ii, Uu, Xu, Uh^Ii, Xu, Uu, Xu, Xu, Uh, Uu, Uu, Xu
Xu, Xu, Xu, Xu, Rb, Uu, Uu, Urb, Urb, Urb, Uu, Uu^Ii, Xom, Xom, Xom, Xom, Xom, Xu, Xu, Xu, Xu, Xu, Xu, Xu, Uu^Ii, Uh, Uu, Uu, Xu, Xu
Xu, Xu, Xu, Xu, Rb, Uu, Rb, Uu, Xu, Uu, Ur^Ii, Ur, Ur, Ur, Ur, Rb, Ur, Xom, Xu, Xu, Xu, Xu, Xu, Xu, Uu, Uu, Uu, Uu^Ii, Xu, Xu
Xu, Xu, Xu, Xu, Xu, Uu, Uu, Rb, Xu, Uu, Xom, Uu, Uu, Ur, Rb, Uu, Ur, Xom, Xom, Uh, Uu^Vu, Xu, Uh, Uh, Uh^Ii, Uu, Xu, Xu, Xu, Xu
Xu, Xu, Xu, Xu, Xu, Uu, Uu^Vu, Uu, Uu, Xu, Xom, Uu, Ur, Ur, Rb, Uu, Xom, Xom, Wwg, Uu, Uu^Efs, Uu, Uu, Uu, Xu, Xu, Xu, Xu, Xu, Xu
Xu, Xu, Xu, Xu, Xu, Uu, Uu, Uu, Xu, Xu, Xom, Uu, Ur, Rb, Uu^Br\, Rb, Xom, Xom, Uu, Uu, Uu^Br/, Uu^Br/, Uu, Xu, Xu, Xu, Xu, Xu, Xu, Xu
Xu, Xu, Xu, Xu, Xu, Xu, Xu, Xu, Xu, Xu, Xom, Rb, Uu, Rb, Uu, Uu^Br\, Uu^Br\, Uu, Uu^Br/, Uu^Br/, Uu, Uu, Wwg, Xom, Xu, Xu, Xu, Xu, Xu, Xu
Xu, Xu, Xu, Xu, Xu, Xu, Xu, Xu, Xu, Xu, Cud, Cud, Cud, Uu, Uu^Vu, Uu, Uu, Uu^Br/, Uu, Uu, Wwg, Uu, Xom, Xom, Xu, Xu, Xu, Xu, Xu, Xu
Xu, Xu, Xu, Xu, Xu, Xu, Xu, Xu, Xu, Xu, Cud, Kud, Cud, Uu, Xom, Xom, Xom, Xom, Xom, Xom, Xom, Xom, Xu, Xu, Xu, Xu, Xu, Xu, Xu, Xu
Xu, Xu, Xu, Xu, Xu, Xu, Xu, Xu, Xu, Xu, Xu, Cud, Xu, Xu, Xu, Xu, Xu, Xu, Xu, Xu, Xu, Xu, Xu, Xu, Xu, Xu, Xu, Xu, Xu, Xu
Xu, Xu, Xu, Xu, Xuc, Xu, Xu, Xu, Xu, Xu, Xu, Xu, Xu, Xu, Xu, Xu, Xu, Xu, Xu, Xu, Xu, Xu, Xu, Xu, Xu, Xu, Xu, Xu, Xu, Xu
